1111111111111
1111100011111
1111000001111
1110000000111
1111000001111
1111100011111
1111111111111