11111111
10P110G1
100C0001
10C00001
1CCCC0E1
11111111